3333333333333333333333
3100044444444000000013
3033333333333333333303
3034000400000400000303
3030333333303333330343
3030300000000000030303
3030303333333333030303
3034303000002003030303
3000300033003300030043
3030303000000003030303
3030303333333333030303
3034300000000000030343
3030333333033333330303
3030300000030000000303
3034303303330333033313
3130003300000333000043